1111111111111111111111111111111111
100000000000010000000C000000000001
1010010100100EC1111110000000101011
1010010010101011001001000000010101
1P0000000C00C0000000000000000000C1
1111111111111111111111111111111111
